1111111111111111111111111111111111
1P0001000000000C00000C000000000001
1010010100100000101001000000010101
10100E0010101010001001000000010101
100001000C00C0000000000000000000C1
1111111111111111111111111111111111
