11111111111111111111
10C00000000000100001
10111110111110111101
10100000000010C00001
10101111111010101111
1010000010001C100001
11111100111111111111
100000C0C00000000001
11111100111111E11111
10100000100010000C01
1C101111111010101011
100000P0000000000C01
11111111111111111111
