111111111111111
1C00000C0000001
101111101111101
101000000000101
101011111110101
1C1000001C001C1
111111001111111
1000000000C0001
1E0C00000000001
111111001111111
1C10000010C0101
101011111110101
101000000000101
101111101111101
100000P00000001
111111111111111